[
    {
        "stagename": "1",
        "stagemap": [[1, 1, 1, 1, 1, 1, 1, 1, 1, 1, 1, 1, 1, 1, 1, 1, 1, 1, 1],
                    [1, 1, 1, 1, 1, 1, 1, 1, 1, 1, 3, 1, 1, 1, 1, 1, 1, 1, 1],
                    [1, 1, 1, 1, 1, 1, 1, 1, 0, 0, 0, 1, 1, 1, 1, 1, 1, 1, 1],
                    [1, 1, 1, 1, 1, 1, 1, 1, 0, 1, 1, 1, 1, 1, 1, 1, 1, 1, 1],
                    [1, 1, 1, 1, 1, 1, 1, 1, 0, 0, 0, 1, 1, 1, 1, 1, 1, 1, 1],
                    [1, 1, 1, 1, 1, 1, 1, 1, 1, 1, 0, 1, 1, 1, 1, 1, 1, 1, 1],
                    [1, 0, 0, 0, 0, 0, 0, 0, 0, 0, 0, 1, 1, 1, 1, 1, 1, 1, 1],
                    [1, 0, 1, 1, 1, 1, 1, 1, 1, 1, 1, 1, 1, 1, 1, 1, 1, 1, 1],
                    [1, 0, 1, 1, 1, 1, 1, 1, 1, 1, 1, 1, 1, 1, 1, 1, 1, 1, 1],
                    [1, 0, 0, 0, 0, 0, 0, 0, 0, 0, 0, 0, 0, 0, 0, 0, 0, 0, 1],
                    [1, 1, 1, 1, 1, 1, 1, 1, 1, 1, 1, 1, 1, 1, 1, 1, 1, 0, 1],
                    [1, 2, 0, 0, 0, 0, 0, 0, 0, 0, 0, 0, 0, 0, 0, 0, 0, 0, 1],
                    [1, 1, 1, 1, 1, 1, 1, 1, 1, 1, 1, 1, 1, 1, 1, 1, 1, 1, 1]],
        "cellsize": 30,
        "pickups": 0,
        "enemies": 0
    },
    {
        "stagename": "2",
        "stagemap": [[1, 1, 1, 1, 1, 1, 1, 1, 1, 1, 1, 1, 1, 1, 1, 1, 1, 1, 1],
                    [1, 0, 0, 0, 0, 0, 0, 0, 0, 0, 0, 0, 0, 0, 0, 0, 0, 4, 1],
                    [1, 0, 1, 1, 1, 1, 1, 1, 1, 1, 1, 1, 1, 1, 1, 1, 1, 1, 1],
                    [1, 0, 1, 1, 1, 1, 1, 1, 1, 1, 1, 1, 1, 1, 1, 1, 1, 1, 1],
                    [1, 0, 1, 1, 1, 1, 1, 1, 1, 1, 1, 1, 1, 1, 1, 1, 1, 1, 1],
                    [1, 0, 1, 1, 1, 1, 1, 1, 1, 1, 1, 1, 1, 1, 1, 1, 1, 1, 1],
                    [1, 0, 1, 1, 1, 1, 1, 1, 1, 6, 0, 0, 0, 0, 0, 0, 0, 0, 1],
                    [1, 0, 1, 1, 1, 1, 1, 1, 1, 1, 1, 1, 1, 1, 1, 1, 1, 0, 1],
                    [1, 0, 1, 1, 1, 1, 1, 1, 1, 1, 1, 1, 1, 1, 1, 1, 1, 0, 1],
                    [1, 0, 1, 1, 1, 1, 1, 1, 1, 1, 1, 1, 1, 1, 1, 1, 1, 0, 1],
                    [1, 0, 1, 1, 1, 1, 1, 1, 1, 1, 1, 1, 1, 1, 1, 1, 1, 0, 1],
                    [1, 0, 0, 0, 0, 0, 0, 0, 0, 0, 0, 0, 0, 0, 0, 0, 0, 0, 1],
                    [1, 1, 1, 1, 1, 1, 1, 1, 1, 1, 1, 1, 1, 1, 1, 1, 1, 1, 1]],
        "cellsize": 30,
        "pickups": 1,
        "enemies": 0
    },
    {
        "stagename": "3",
        "stagemap": [[1, 1, 1, 1, 1, 1, 1, 1, 1, 1, 1, 1, 1, 1, 1, 1, 1, 1, 1],
                    [1, 0, 1, 0, 0, 0, 0, 0, 0, 0, 0, 0, 0, 0, 0, 0, 0, 3, 1],
                    [1, 0, 1, 0, 0, 0, 0, 0, 0, 7, 0, 0, 0, 0, 0, 0, 1, 3, 1],
                    [1, 0, 1, 0, 0, 0, 0, 0, 0, 8, 0, 0, 0, 0, 0, 0, 1, 3, 1],
                    [1, 0, 1, 0, 0, 0, 0, 0, 0, 7, 0, 0, 0, 0, 0, 0, 1, 3, 1],
                    [1, 0, 1, 0, 0, 0, 0, 0, 0, 8, 0, 0, 0, 0, 0, 0, 1, 3, 1],
                    [1, 2, 1, 0, 0, 0, 0, 0, 0, 7, 0, 0, 0, 0, 0, 0, 1, 3, 1],
                    [1, 0, 1, 0, 0, 0, 0, 0, 0, 8, 0, 0, 0, 0, 0, 0, 1, 3, 1],
                    [1, 0, 1, 0, 0, 0, 0, 0, 0, 7, 0, 0, 0, 0, 0, 0, 1, 3, 1],
                    [1, 0, 1, 0, 0, 0, 0, 0, 0, 8, 0, 0, 0, 0, 0, 0, 1, 3, 1],
                    [1, 0, 1, 0, 0, 0, 0, 0, 0, 7, 0, 0, 0, 0, 0, 0, 1, 3, 1],
                    [1, 0, 0, 0, 0, 0, 0, 0, 0, 0, 0, 0, 0, 0, 0, 0, 1, 3, 1],
                    [1, 1, 1, 1, 1, 1, 1, 1, 1, 1, 1, 1, 1, 1, 1, 1, 1, 1, 1]],
        "cellsize": 30,
        "pickups": 0,
        "enemies": 2,
        "enemy7": [1, 6, 0],
        "enemy8": [1, -6, 0]
    },
    {
        "stagename": "4",
        "stagemap": [[1, 1, 1, 1, 1, 1, 1, 1, 1, 1, 1, 1, 1, 1, 1, 1, 1, 1, 1],
                    [1, 1, 1, 1, 7, 0, 7, 0, 7, 0, 7, 0, 7, 0, 7, 1, 1, 1, 1],
                    [1, 1, 1, 1, 0, 0, 0, 0, 0, 0, 0, 0, 0, 0, 0, 1, 1, 1, 1],
                    [1, 1, 1, 1, 0, 0, 0, 0, 0, 0, 0, 0, 0, 0, 0, 1, 1, 1, 1],
                    [1, 1, 1, 1, 0, 0, 0, 0, 0, 0, 0, 0, 0, 0, 0, 1, 1, 1, 1],
                    [1, 0, 0, 0, 0, 0, 0, 0, 0, 0, 0, 0, 0, 0, 0, 3, 3, 3, 1],
                    [1, 0, 2, 0, 0, 0, 0, 0, 0, 4, 0, 0, 0, 0, 0, 3, 3, 3, 1],
                    [1, 0, 0, 0, 0, 0, 0, 0, 0, 0, 0, 0, 0, 0, 0, 3, 3, 3, 1],
                    [1, 1, 1, 1, 0, 0, 0, 0, 0, 0, 0, 0, 0, 0, 0, 1, 1, 1, 1],
                    [1, 1, 1, 1, 0, 0, 0, 0, 0, 0, 0, 0, 0, 0, 0, 1, 1, 1, 1],
                    [1, 1, 1, 1, 0, 0, 0, 0, 0, 0, 0, 0, 0, 0, 0, 1, 1, 1, 1],
                    [1, 1, 1, 1, 0, 8, 0, 8, 0, 8, 0, 8, 0, 8, 0, 1, 1, 1, 1],
                    [1, 1, 1, 1, 1, 1, 1, 1, 1, 1, 1, 1, 1, 1, 1, 1, 1, 1, 1]],
        "cellsize": 30,
        "pickups": 1,
        "enemies": 2,
        "enemy7": [1, 0, 4],
        "enemy8": [1, 0, -4]
    },
    {
        "stagename": "5",
        "stagemap": [[1, 1, 1, 1, 1, 1, 1, 1, 1, 1, 1, 1, 1, 1, 1, 1, 1, 1, 1],
                    [1, 0, 0, 0, 0, 0, 0, 1, 1, 1, 1, 1, 1, 1, 1, 1, 3, 3, 1],
                    [1, 1, 0, 0, 1, 1, 0, 8, 1, 1, 1, 1, 1, 1, 1, 1, 3, 3, 1],
                    [1, 7, 0, 0, 0, 1, 0, 0, 0, 1, 1, 1, 1, 1, 1, 1, 3, 3, 1],
                    [1, 1, 5, 0, 1, 1, 0, 0, 0, 9, 1, 1, 1, 1, 1, 1, 3, 3, 1],
                    [1, 1, 0, 0, 1, 1, 0, 0, 0, 0, 0, 1, 1, 1, 1, 1, 3, 3, 1],
                    [1, 7, 0, 0, 0, 1, 0, 0, 0, 0, 0, 10, 1, 1, 1, 1, 3, 3, 1],
                    [1, 1, 0, 5, 1, 1, 0, 0, 0, 0, 0, 0, 0, 1, 1, 1, 3, 3, 1],
                    [1, 1, 0, 0, 1, 1, 0, 0, 0, 0, 0, 0, 0, 11, 1, 1, 3, 3, 1],
                    [1, 7, 0, 0, 0, 1, 0, 0, 0, 0, 0, 0, 0, 0, 0, 1, 3, 3, 1],
                    [1, 1, 5, 0, 1, 1, 0, 0, 0, 0, 0, 0, 0, 0, 0, 1, 3, 3, 1],
                    [1, 1, 2, 0, 1, 1, 0, 0, 0, 0, 0, 0, 0, 0, 0, 0, 0, 0, 1],
                    [1, 1, 1, 1, 1, 1, 1, 1, 1, 1, 1, 1, 1, 1, 1, 1, 1, 1, 1]],        
        "cellsize": 30,
        "pickups": 0,
        "enemies": 5,
        "enemy7": [1, 4, 0],
        "enemy8": [1, 0, 7],
        "enemy9": [1, 0, 6],
        "enemy10": [1, 0, 5],
        "enemy11": [1, 0, 4]
    },
    {
        "stagename": "6",
        "stagemap": [[1, 1, 1, 1, 1, 1, 1, 1, 1, 1, 1, 1, 1, 1, 1, 1, 1, 1, 1],
                    [1, 1, 1, 1, 1, 1, 1, 1, 1, 1, 1, 1, 1, 1, 1, 1, 1, 1, 1],
                    [1, 1, 1, 1, 1, 1, 1, 1, 1, 1, 1, 1, 4, 1, 1, 1, 1, 1, 1],
                    [1, 1, 1, 1, 1, 4, 0, 0, 0, 0, 0, 0, 9, 1, 1, 1, 1, 1, 1],
                    [1, 1, 1, 1, 1, 1, 0, 0, 0, 0, 0, 8, 0, 1, 1, 1, 1, 1, 1],
                    [1, 1, 1, 1, 1, 1, 0, 0, 0, 0, 7, 0, 0, 1, 1, 1, 1, 1, 1],
                    [1, 1, 1, 1, 1, 1, 0, 0, 0, 6, 0, 0, 0, 1, 1, 1, 1, 1, 1],
                    [1, 1, 1, 1, 1, 1, 0, 0, 0, 0, 0, 0, 0, 1, 1, 1, 1, 1, 1],
                    [1, 1, 1, 1, 1, 1, 0, 0, 0, 0, 0, 0, 0, 1, 1, 1, 1, 1, 1],
                    [1, 1, 1, 1, 1, 1, 0, 0, 0, 0, 0, 0, 0, 4, 1, 1, 1, 1, 1],
                    [1, 1, 1, 1, 1, 1, 4, 1, 1, 1, 1, 1, 1, 1, 1, 1, 1, 1, 1],
                    [1, 1, 1, 1, 1, 1, 1, 1, 1, 1, 1, 1, 1, 1, 1, 1, 1, 1, 1],
                    [1, 1, 1, 1, 1, 1, 1, 1, 1, 1, 1, 1, 1, 1, 1, 1, 1, 1, 1]],        
        "cellsize": 30,
        "pickups": 4,
        "enemies": 3,
        "enemy7": [2, 2, 2, 3],
        "enemy8": [2, 4, 4, 6],
        "enemy9": [2, 6, 6, 9]
    },
    {
        "stagename": "7",
        "stagemap": [[1, 1, 1, 1, 1, 1, 1, 1, 1, 1, 1, 1, 1, 1, 1, 1, 1, 1, 1],
                    [1, 1, 1, 1, 1, 1, 1, 1, 1, 2, 1, 1, 1, 1, 1, 1, 1, 1, 1],
                    [1, 1, 1, 1, 1, 0, 0, 0, 0, 0, 0, 0, 0, 10, 1, 1, 1, 1, 1],
                    [1, 1, 1, 1, 1, 0, 0, 0, 0, 0, 0, 0, 9, 0, 1, 1, 1, 1, 1],
                    [1, 1, 1, 1, 1, 0, 0, 0, 0, 4, 0, 8, 0, 0, 1, 1, 1, 1, 1],
                    [1, 1, 3, 3, 3, 0, 0, 0, 0, 0, 7, 0, 0, 0, 1, 1, 1, 1, 1],
                    [1, 1, 3, 3, 3, 0, 0, 4, 0, 1, 0, 4, 0, 0, 1, 1, 1, 1, 1],
                    [1, 1, 3, 3, 3, 0, 0, 0, 0, 0, 0, 0, 0, 0, 1, 1, 1, 1, 1],
                    [1, 1, 1, 1, 1, 0, 0, 0, 0, 4, 0, 0, 0, 0, 1, 1, 1, 1, 1],
                    [1, 1, 1, 1, 1, 0, 0, 0, 0, 0, 0, 0, 0, 0, 1, 1, 1, 1, 1],
                    [1, 1, 1, 1, 1, 0, 0, 0, 0, 0, 0, 0, 0, 0, 1, 1, 1, 1, 1],
                    [1, 1, 1, 1, 1, 1, 1, 1, 1, 1, 1, 1, 1, 1, 1, 1, 1, 1, 1],
                    [1, 1, 1, 1, 1, 1, 1, 1, 1, 1, 1, 1, 1, 1, 1, 1, 1, 1, 1]],        
        "cellsize": 30,
        "pickups": 3,
        "enemies": 4,
        "enemy7": [2, 2, 2, 2],
        "enemy8": [2, 4, 4, 4],
        "enemy9": [2, 6, 6, 6],
        "enemy10": [2, 8, 8, 8]
    },
    {
        "stagename": "8",
        "stagemap": [[1, 1, 1, 1, 1, 1, 1, 1, 1, 1, 1, 1, 1, 1, 1, 1, 1, 1, 1],
                    [1, 1, 1, 1, 1, 1, 1, 1, 1, 1, 1, 1, 1, 1, 1, 1, 1, 1, 1],
                    [1, 1, 1, 1, 0, 0, 0, 7, 1, 1, 4, 0, 0, 7, 1, 1, 1, 1, 1],
                    [1, 1, 1, 1, 0, 2, 1, 0, 0, 0, 8, 1, 1, 0, 1, 1, 1, 1, 1],
                    [1, 1, 1, 1, 0, 1, 1, 0, 1, 1, 0, 1, 1, 0, 1, 1, 1, 1, 1],
                    [1, 1, 1, 1, 0, 1, 1, 0, 1, 1, 0, 1, 1, 0, 3, 3, 3, 1, 1],
                    [1, 1, 1, 1, 0, 0, 0, 7, 1, 1, 0, 0, 0, 7, 3, 3, 3, 1, 1],
                    [1, 1, 1, 1, 0, 1, 1, 0, 1, 1, 0, 1, 1, 0, 3, 3, 3, 1, 1],
                    [1, 1, 1, 1, 0, 1, 1, 0, 1, 1, 0, 1, 1, 0, 1, 1, 1, 1, 1],
                    [1, 1, 1, 1, 0, 1, 1, 0, 0, 0, 0, 1, 1, 0, 1, 1, 1, 1, 1],
                    [1, 1, 1, 1, 4, 0, 0, 0, 1, 1, 0, 0, 0, 4, 1, 1, 1, 1, 1],
                    [1, 1, 1, 1, 1, 1, 1, 1, 1, 1, 1, 1, 1, 1, 1, 1, 1, 1, 1],
                    [1, 1, 1, 1, 1, 1, 1, 1, 1, 1, 1, 1, 1, 1, 1, 1, 1, 1, 1]],        
        "cellsize": 30,
        "pickups": 3,
        "enemies": 2,
        "enemy7": [2, 3, 4, 3],
        "enemy8": [2, 3, 6, 3]
    },
    {
        "stagename": "9",
        "stagemap": [[1, 1, 1, 1, 1, 1, 1, 1, 1, 1, 1, 1, 1, 1, 1, 1, 1, 1, 1],
                    [1, 1, 2, 0, 0, 0, 7, 0, 0, 0, 7, 0, 0, 0, 7, 0, 1, 1, 1],
                    [1, 1, 1, 0, 0, 8, 0, 0, 0, 8, 0, 0, 0, 8, 0, 0, 1, 1, 1],
                    [1, 1, 1, 0, 0, 0, 0, 0, 0, 0, 0, 0, 0, 0, 0, 0, 1, 1, 1],
                    [1, 1, 1, 0, 0, 0, 0, 0, 0, 0, 0, 0, 0, 0, 0, 0, 1, 1, 1],
                    [1, 1, 1, 1, 1, 1, 1, 1, 1, 1, 1, 1, 1, 1, 1, 0, 1, 1, 1],
                    [1, 1, 1, 1, 1, 1, 1, 1, 1, 1, 1, 1, 1, 1, 1, 0, 1, 1, 1],
                    [1, 1, 1, 4, 0, 0, 7, 4, 0, 0, 7, 4, 0, 0, 7, 0, 1, 1, 1],
                    [1, 1, 1, 0, 0, 8, 0, 0, 0, 8, 0, 0, 0, 8, 0, 0, 1, 1, 1],
                    [1, 1, 1, 0, 0, 0, 0, 0, 0, 0, 0, 0, 0, 0, 0, 0, 1, 1, 1],
                    [1, 1, 3, 0, 0, 0, 0, 0, 0, 0, 0, 0, 0, 0, 0, 0, 1, 1, 1],
                    [1, 1, 1, 1, 1, 1, 1, 1, 1, 1, 1, 1, 1, 1, 1, 1, 1, 1, 1],
                    [1, 1, 1, 1, 1, 1, 1, 1, 1, 1, 1, 1, 1, 1, 1, 1, 1, 1, 1]],        
        "cellsize": 30,
        "pickups": 2,
        "enemies": 2,
        "enemy7": [2, 3, 3, 3],
        "enemy8": [2, 1, 1, 2]
    }
]