[
    {
        "stagenumber": 1,
        "stagemap": [[1, 1, 1, 1, 1, 1, 1, 1, 1],
                    [1, 4, 0, 0, 0, 0, 0, 3, 1],
                    [1, 0, 0, 0, 0, 0, 0, 3, 1],
                    [1, 0, 0, 0, 0, 0, 0, 3, 1],
                    [1, 2, 0, 0, 0, 0, 0, 3, 1],
                    [1, 1, 1, 1, 1, 1, 1, 1, 1]],
        "cellsize": 30,
        "pickups": 1
    },
    {
        "stagenumber": 2,
        "stagemap": [[1, 1, 1, 1, 1, 1, 1, 1, 1],
                    [1, 2, 0, 0, 0, 0, 0, 3, 1],
                    [1, 0, 0, 0, 0, 0, 0, 3, 1],
                    [1, 0, 0, 0, 0, 0, 0, 3, 1],
                    [1, 0, 0, 0, 4, 0, 0, 3, 1],
                    [1, 1, 1, 1, 1, 1, 1, 1, 1]],
        "cellsize": 30,
        "pickups": 1
    },
    {
        "stagenumber": 3,
        "stagemap": [[1, 1, 1, 1, 1, 1, 1, 1, 1, 1, 1, 1, 1],
                    [1, 0, 0, 0, 1, 0, 0, 0, 1, 0, 0, 0, 1],
                    [1, 0, 1, 0, 1, 0, 1, 0, 1, 0, 1, 0, 1],
                    [1, 0, 1, 0, 1, 0, 1, 0, 1, 0, 1, 0, 1],
                    [1, 0, 1, 0, 1, 0, 1, 0, 1, 0, 1, 0, 1],
                    [1, 2, 1, 0, 0, 0, 1, 0, 0, 0, 1, 3, 1],
                    [1, 1, 1, 1, 1, 1, 1, 1, 1, 1, 1, 1, 1]],
        "cellsize": 30,
        "pickups": 0
    },
    {
    "stagenumber": 4,
    "stagemap": [[1, 1, 1, 1, 1, 1, 1, 1, 1, 1, 1, 1, 1],
                [1, 4, 0, 0, 0, 0, 0, 0, 0, 0, 0, 4, 1],
                [1, 1, 1, 1, 1, 1, 0, 1, 1, 1, 1, 1, 1],
                [1, 0, 0, 0, 1, 1, 0, 1, 1, 0, 0, 4, 1],
                [1, 0, 1, 0, 1, 1, 0, 1, 1, 0, 1, 1, 1],
                [1, 0, 1, 0, 1, 3, 3, 3, 1, 0, 1, 4, 1],
                [1, 0, 1, 0, 1, 3, 2, 3, 1, 0, 1, 0, 1],
                [1, 0, 1, 0, 1, 3, 3, 3, 1, 0, 1, 0, 1],
                [1, 0, 1, 0, 1, 0, 1, 0, 0, 0, 0, 0, 1],
                [1, 0, 1, 0, 1, 0, 1, 1, 1, 1, 1, 0, 1],
                [1, 0, 1, 0, 1, 0, 1, 0, 0, 0, 1, 0, 1],
                [1, 4, 1, 0, 0, 0, 1, 4, 1, 0, 0, 0, 1],
                [1, 1, 1, 1, 1, 1, 1, 1, 1, 1, 1, 1, 1]],
    "cellsize": 30,
    "pickups": 6
    }
]